Table
BBSSDestination
ANY|Any
ABD|ABU DHABI
AFG|AFGHANISTAN
AGT|ARGENTINA
ALB|ARUBA
ALG|ALGERIA
ANG|ANGOLA
ANT|ANTIGUA
ARB|SAUDI ARABIA
ARM|ARMENIA
ASR|AUSTRALIA
AUS|AUSTRIA
AZB|AZERBAIJAN
BAM|BERMUDA
BAR|BARBADOS
BEL|BELGIUM
BEM|BERMUDA
BEN|BENIN
BGB|EGB FOR 120 WITHOUT YEAR8 APPL
BGR|GER FOR 120 WITHOUT YEAR8 APPL
BHM|BAHAMAS
BHU|RW   TRANSMISSION
BIR|IRL FOR 120 WITHOUT YEAR8 APPL
BLG|BULGARIA
BLZ|BELIZE
BNG|BANGLADESH
BNL|GSIS TRANSMISSION
BOL|BOLIVIA
BRA|BRAZIL
BRD|BURUNDI
BRK|BURKINA FASO
BRN|BAHRAIN
BSW|SWEDEN 120 WITHOUT YEAR8
BTW|BOTSWANA
BUL|DONT USE
CAB|CAPE VERDE
CAF|CENTRAL AFRICA
CAN|CANADA          N
CAR|CAMEROON
CEE|CENTRAL EASTERN RBU
CEN|CENTRAL RBU EUROPE
CGO|CONGO
CHD|CHAD
CHL|CHILE
CMB|CAMBODIA
CMR|COMOROS
CNR|CANARIES
COK|COOK ISLANDS
COL|COLOMBIA
COM|COMOROS
CRO|CROATIA
CST|COSTA RICA
CUB|CUBA
CUR|CURACAO
CVH|COMPANY VEHICLE
CYM|CEUTA
CYP|CYPRUS
CZE|CZECHOSLOVAKIA
DBY|DUBAI
DEN|DENMARK
DJI|DJIBOUTI
DMT|COMMONWEALTH OF DOMINICA
DOM|DOMINICAN REP.
ECA|ECUADOR
EGB|GREAT BRITAIN
EGP|EGYPT
ELS|EL SALVADOR
ENG|ENGLAND
ERI|ERITREA
EST|ESTONIA
ETH|ETHIOPIA
FGI|FRENCH GUYANA
FIJ|FIDJI
FIN|FINLAND
FRA|FRANCE
FRN|GSIS TRANSMISSION
GAM|GAMBIA
GBN|GABON
GBS|GUINEA BISSAU
GCA|GRAN CAYMAN
GCC|GULF COAST COUNTRIES
GDL|GUADELOUPE
GER|GERMANY
GGY|NATO FORCES
GHA|GHANA
GIB|GIBRALTER
GNE|EQUATORIAL GUINEA
GRE|GREECE
GRN|GRENADA
GRZ|GEORGIA
GUI|GUYANA
GUM|GUAM
GUN|GUINEA
GUT|GUATEMALA
HAW|GSIS TRANSMISSION
HIT|HAITI
HKG|HONG KONG
HND|HONDURAS
HOL|HOLLAND
HUN|HUNGARY
IBE|IBERIA RBU EUROPE
ICE|ICELAND
ICO|INFINITI NORTH EURO
ICR|INFINITI CROATIA
IES|INFINITI EUROPE ( SOUTH )
IEU|INFINITI EURO ( CEN & WES )
IGR|INFINITI GREECE
IIR|INFINITI IRELAND
IIS|INFINITI ISRAEL
IRL|IRELAND
IRN|IRAN
IRQ|IRAQ
ISE|INFINITI SERBIA
ISP|INFINITI SPAIN
ISR|ISRAEL
ITA|ITALY
ITR|INFINITI TURKEY
IUK|INFINITI UK
IVO|IVORY COAST
JAM|JAMAICA
JOR|JORDAN
JPN|JAPAN
JPY|JAPAN
KGS|KYRGYZSTAN
KIR|GSIS TRANSMISSION
KNY|KENYA
KRA|KOREA
KUW|KUWAIT
KZH|KAZAKHSTAN
LAO|LAOS
LBY|LIBYA
LEB|LEBANON
LES|LESOTHO
LIB|LIBERIA
MAL|MALI
MAR|MARTINIQUE
MAU|MAURITIUS
MDV|GSIS TRANSMISSION
MEX|MEXICO
MLG|MADAGASCAR
MLT|MALTA
MLW|MALAWI
MLY|MALAYSIA
MOG|MONGOL
MOM|OMAN
MON|MONTSERRAT
MOR|MOROCCO
MTA|MAURITANIA
MTS|MAURITIUS
MZQ|MOZAMBIQUE
NAI|GSIS TRANSMISSION
NAM|NAMIBIA
NAT|DO NOT USE
NCA|NEW CALEDONIA
NEP|NEPAL
NFI|GSIS TRANSMISSION
NGR|NIGER
NIC|NICARAGUA
NIG|NIGERIA
NME|NME
NMS|NISSAN MOTORSPORTS EUROPE
NNE|SCANDANAVIAN GROUP COUNTRIES
NOR|NORWAY
NZE|NEW ZEALAND.
PAK|PAKISTAN
PER|PERU
PLT|PUERTO RICO
PNA|PALESTINE
PNG|PAPUA NEW GUINEA
PNM|PANAMA
POL|POLAND
POR|PORTUGAL
PRC|CHINA
PRG|PARAGUAY
QA|QA BODY
QAT|QATAR
REU|REUNION ISLES
RUM|RUMANIA
RWA|RWANDA
SAF|SOUTH AFRICA
SAO|SAO TOME PRINCIPE
SEN|SENEGAL
SER|SERVICE
SEY|SEYCHELLES ISLAND
SIN|SINGAPORE
SLA|SLOVAKIA
SLK|SRI LANKA
SLV|SLOVENIA
SOL|SOLOMAN
SOM|SOMALIA
SPA|SPAIN
SRI|SURINAME
SRL|SIERRA LEONE
STK|ST KITTS
STL|ST LUCIA
STM|SAINT MARTIN
STV|ST VINCENT
SUD|SUDAN
SWE|SWEDEN
SWI|SWITZERLAND
SWZ|SWAZILAND
SYR|SYRIA
TAH|TAHITI
TGO|TOGO
TKY|TURKEY
TMS|TURKMENISTAN
TNZ|TANZANIA
TON|GSIS TRANSMISSION
TRD|TRINIDAD TOBAGO
TST|TEST DATA
TTT|TEST ONLY
TUN|TUNISIA
TVL|GSIS TRANSMISSION
TWN|TAIWAN
TZK|TAJIKISTAN
UGA|UGANDA
UKR|UKRAINE
URU|URUGUAY
USA|UNITED STATES
USR|SOVIET UNION
UZB|UZBEKISTAN
VAN|VANUATU
VEH|DEST OF PRODN ENGINE
VIT|VIETNAM
VNZ|VENEZUELA
WES|WEST RBU EUROPE
WSA|GSIS TRANSMISSION
WSH|WEST SAHARA
XFI|SCORE II TRIAL C - FIN
XFR|SCORE II TRIAL C -FRA
XGB|SCORE II TRIAL C -EGB
XGE|SCORE II TRIAL C - GER
YEM|YEMEN
YGB|SCORE II TRIAL D - EGB
YGE|SCORE II TRIAL D - GER
YIT|SCORE II TRIAL D-ITA
YSP|SCORE II TRIAL D-SPA
YSW|SCORE II TRIAL D - SWE
YUG|LJUBLJANA
ZAB|ZAMBIA
ZAI|ZAIRE
ZGB|SCORE II TRIAL E-EGB
ZIT|SCORE II TRIAL E-ITA
ZRO|ZIMBABWE
ZSP|SCORE II TRIAL E-SPA
ZZZ|NISSAN EUROPE

